type octile
height 9
width 5
map0
.....
.....
.....
.....
@....
@.@@@
..@..
..@@.
.....