type octile
height 7
width 5
map0
.....
.....
.....
.....
.....
.....
.....